0,0,0,0,0,0,0,0,0,0,0,0,0,0,0,0,0,0,0,0,0,0,0,0,0,0,0,0,0,0,0,0,0,0,0,0,0,0,0,0,0,0,0,0,0,0,0,0,0,0,0,0,0,0,0,0,0,0,0,0,0,0,0,0,0,0,0,0,0,0
0,0,0,0,0,0,0,0,0,0,0,0,0,0,0,0,0,0,0,0,0,0,0,0,0,0,0,0,0,0,0,0,0,0,0,0,0,0,0,0,0,0,0,0,0,0,0,0,0,0,0,0,0,0,0,0,0,0,0,0,0,0,0,0,0,0,0,0,0,0
0,0,0,0,0,0,0,0,0,0,0,0,0,0,0,0,0,0,0,0,0,0,0,0,0,0,0,0,0,0,0,0,0,0,0,0,0,0,0,0,0,0,0,0,0,0,0,0,0,0,0,0,0,0,0,0,0,0,0,0,0,0,0,0,0,0,0,0,0,0
0,0,0,0,0,0,0,0,0,0,0,0,0,0,0,0,0,0,0,0,0,0,0,0,0,0,0,0,0,0,0,0,0,0,0,0,0,0,0,0,0,0,0,0,0,0,0,0,0,0,0,0,0,0,0,0,0,0,0,0,0,0,0,0,0,0,0,0,0,0
0,0,0,0,0,0,0,0,0,0,0,0,0,0,0,0,0,0,0,0,0,0,0,0,0,0,0,0,0,0,0,0,0,0,0,0,0,0,0,0,0,0,0,0,0,0,0,0,0,0,0,0,0,0,0,0,0,0,0,0,0,0,0,0,0,0,0,0,0,0
0,0,0,0,0,0,0,0,0,0,0,0,0,0,0,0,0,0,0,0,0,0,0,0,0,0,0,0,0,0,0,0,0,0,0,0,0,0,0,0,0,0,0,0,0,0,0,0,0,0,0,0,0,0,0,1,1,0,0,0,0,0,0,0,0,0,0,0,0,0
0,0,0,0,0,0,0,0,0,0,0,0,0,0,0,0,0,0,0,0,0,0,0,0,0,0,0,0,0,0,0,0,0,0,0,0,0,0,0,0,0,0,0,0,0,0,0,0,0,0,0,0,0,0,0,0,0,0,0,0,1,0,0,0,0,0,0,0,0,0
0,0,0,0,0,0,0,0,0,0,0,0,0,0,0,0,0,0,0,0,0,0,0,0,0,0,0,0,0,0,0,0,0,0,0,0,0,0,0,0,0,0,0,0,0,0,0,0,0,0,0,0,0,0,0,0,0,0,0,0,0,0,0,1,0,0,0,0,0,0
0,0,0,0,0,0,0,0,0,0,0,0,0,0,0,0,0,0,0,0,0,0,0,0,0,0,0,0,0,0,0,0,0,0,0,0,0,0,0,0,0,0,1,0,0,0,0,0,0,0,0,0,0,0,0,0,0,0,0,0,0,0,0,0,0,0,0,0,0,0
0,0,0,0,0,0,0,0,0,0,0,0,0,0,0,0,0,0,0,0,0,0,0,0,0,0,0,0,0,0,0,0,0,0,0,0,0,0,0,0,0,0,0,0,0,0,0,0,0,0,0,0,0,0,1,0,0,0,0,0,0,0,0,0,0,0,0,0,0,0
0,0,0,0,0,0,0,0,0,0,0,0,0,0,0,0,0,0,0,0,0,0,0,0,0,0,0,0,0,0,0,0,0,0,0,0,0,0,0,0,0,0,0,0,0,0,0,0,0,0,0,0,1,0,0,0,0,0,0,0,0,0,0,0,0,0,2,1,0,0
0,0,0,0,0,0,0,0,0,0,0,0,0,0,0,0,0,0,0,0,0,0,0,0,0,0,0,0,0,0,0,0,0,0,0,0,0,0,0,0,0,0,0,0,0,0,0,0,0,0,0,0,0,1,0,0,0,0,1,1,0,0,0,0,0,1,0,0,0,1
0,0,0,0,0,0,0,0,0,0,0,0,0,0,0,0,0,0,0,0,0,0,0,0,0,0,0,0,0,0,0,0,0,0,0,0,0,0,0,0,0,0,0,0,0,0,0,0,0,0,0,0,0,0,0,0,0,0,1,0,0,0,1,0,0,0,0,1,0,0
0,0,0,0,0,0,0,0,0,0,0,0,0,0,0,0,0,0,0,0,0,0,0,0,0,0,0,0,0,0,0,0,0,0,0,0,0,0,0,0,0,0,0,0,0,0,1,0,0,0,0,0,0,0,0,0,1,0,0,1,0,0,0,0,1,1,0,0,0,0
0,0,0,0,0,0,0,0,0,0,0,0,0,0,0,0,0,0,0,0,0,0,0,0,0,0,0,0,0,0,0,0,0,0,0,0,0,0,0,0,0,0,0,0,0,0,0,0,0,0,0,0,0,0,1,0,0,0,0,0,0,0,0,3,0,0,0,0,1,0
0,0,0,0,0,0,0,0,0,0,0,0,0,0,0,0,0,0,0,0,0,0,0,0,0,0,0,0,0,0,0,0,0,0,0,0,0,0,0,1,0,0,0,0,0,0,0,1,0,0,2,0,0,0,0,0,0,0,0,0,0,0,2,0,0,0,0,0,2,0
0,0,0,0,0,0,0,0,0,0,0,0,0,0,0,0,0,0,0,0,0,0,0,0,0,0,0,0,0,0,0,0,1,0,0,0,1,1,0,0,0,0,0,2,0,0,0,0,0,0,1,1,0,0,1,0,1,0,1,0,0,0,0,1,0,0,0,0,0,0
0,0,0,0,0,0,0,0,0,0,0,0,0,0,0,0,0,0,0,0,0,0,0,1,0,0,0,0,0,0,0,0,0,0,0,0,0,2,0,1,0,1,0,0,1,0,0,1,0,0,1,0,0,1,0,0,0,1,0,0,0,1,2,0,1,0,1,1,0,1
0,0,0,0,0,0,0,0,0,0,0,0,0,0,0,0,0,0,0,0,0,0,0,0,0,0,0,1,0,0,1,0,0,0,0,0,0,0,0,0,0,1,0,0,0,1,1,0,0,0,1,1,0,1,0,0,1,0,1,0,1,0,2,1,1,0,1,0,0,0
0,0,0,0,0,0,0,0,0,0,0,0,0,0,0,0,0,0,0,0,0,0,1,0,0,0,0,0,0,1,0,0,0,2,0,0,0,1,0,0,1,1,0,2,3,0,0,0,0,0,0,1,2,0,1,0,0,4,0,0,0,1,0,1,1,1,0,1,0,1
0,0,0,0,0,0,0,0,0,0,0,0,0,0,0,0,0,0,0,0,0,0,0,0,0,0,0,1,0,1,1,1,1,2,0,0,0,0,0,1,0,1,0,0,1,0,0,0,1,0,1,0,1,1,0,0,1,0,0,1,2,2,0,0,1,1,2,0,1,0
0,0,0,0,0,0,0,0,0,0,0,0,0,0,0,0,0,0,1,0,0,0,0,0,0,0,0,1,0,0,4,0,0,0,1,0,1,2,1,0,1,0,2,1,0,1,0,2,0,0,2,2,1,0,0,2,1,1,0,2,1,1,1,1,0,0,4,0,1,2
0,0,0,0,0,0,0,0,0,0,0,0,0,0,0,0,0,0,0,1,0,0,0,0,2,5,1,1,0,1,2,1,0,1,2,2,2,1,1,2,1,1,2,1,2,0,0,1,0,0,0,0,3,1,1,0,0,0,3,0,1,0,0,0,3,2,4,0,1,1
0,0,0,0,0,0,0,0,0,0,0,0,0,0,0,0,0,1,0,0,0,0,0,1,0,0,0,1,0,1,1,1,2,0,1,3,2,0,1,1,1,0,1,0,0,2,1,2,1,0,1,2,1,3,1,0,2,3,2,2,0,0,1,3,0,1,1,2,0,1
0,0,0,0,0,0,0,0,0,0,0,1,0,0,0,0,1,1,0,0,2,1,1,0,2,0,1,1,0,2,1,1,2,0,1,0,0,1,1,1,3,1,0,1,0,1,0,0,0,1,1,0,3,3,1,1,2,1,1,1,2,3,1,0,0,0,0,4,2,2
0,0,0,0,0,0,0,0,0,0,0,0,0,1,1,0,0,1,1,0,5,1,1,1,2,3,1,1,1,2,1,2,2,0,2,2,2,3,3,1,1,2,1,0,1,1,1,2,2,2,1,1,3,1,2,0,1,0,2,0,2,2,0,2,0,0,2,2,1,0
0,0,0,0,0,0,0,0,0,0,1,0,1,2,0,1,1,1,3,1,0,2,0,1,4,4,2,1,3,2,1,0,0,3,3,1,0,2,1,0,1,5,5,1,4,3,2,2,2,2,2,2,4,3,1,2,3,2,2,2,1,1,1,2,0,0,0,1,1,0
0,0,0,0,0,0,0,1,0,0,0,0,2,0,1,0,2,3,2,0,2,0,0,1,4,3,0,1,3,2,3,1,3,3,1,1,0,1,1,2,4,2,4,0,4,2,2,3,2,3,3,1,1,0,0,1,0,1,1,1,2,2,3,1,2,1,2,1,4,2
0,0,0,0,0,0,0,0,0,0,3,4,5,1,3,4,5,2,3,2,3,4,3,2,1,3,1,1,4,3,6,6,1,5,5,5,2,2,0,5,3,1,2,2,3,3,3,1,3,1,1,3,2,1,5,2,1,5,1,2,1,2,4,3,2,1,0,2,3,2
0,0,0,0,0,0,0,1,0,1,2,3,2,6,6,5,4,6,6,3,3,3,5,8,5,3,3,6,5,8,0,2,4,0,1,5,5,2,0,2,3,3,2,5,3,1,1,4,3,1,3,4,3,3,3,2,3,1,0,2,0,4,0,2,2,1,3,0,2,2
0,0,0,0,0,0,0,2,3,4,7,12,6,2,5,8,8,6,2,3,5,9,3,6,8,5,5,6,1,3,4,2,2,5,2,2,1,6,7,8,0,1,2,1,2,3,5,1,3,4,0,0,4,4,3,1,1,1,2,3,0,5,3,2,2,3,1,1,3,3
0,0,0,0,0,0,0,1,3,4,9,2,8,12,6,8,8,11,4,3,5,3,6,8,4,4,3,2,6,5,5,7,2,2,7,9,3,2,3,3,4,3,2,6,1,2,3,2,6,2,3,1,0,2,0,2,1,1,1,8,1,0,0,2,3,1,1,2,2,1
0,0,0,0,0,0,1,5,12,18,12,5,16,4,14,6,12,9,12,8,8,4,4,4,7,7,7,7,3,2,3,4,3,2,3,5,5,3,1,7,3,3,4,3,5,4,1,5,5,2,1,3,2,4,2,5,1,1,6,1,1,4,2,3,3,4,2,3,6,1
0,0,0,0,0,0,3,14,32,38,20,22,11,12,15,14,15,8,14,9,11,8,5,9,7,6,7,4,2,7,5,6,6,8,5,8,7,5,2,3,5,3,2,2,2,1,5,3,5,4,4,6,5,1,2,0,5,3,0,1,1,1,2,1,2,5,2,1,3,1
0,0,0,0,0,0,14,67,47,30,46,20,26,14,16,10,10,14,13,8,9,5,8,8,9,10,10,9,2,3,5,9,3,4,8,7,3,3,2,4,5,2,3,1,6,2,4,2,1,7,3,2,0,2,6,0,1,4,3,1,2,6,1,1,4,2,2,3,2,5
0,0,0,0,0,3,86,177,78,51,27,32,18,21,24,14,14,13,15,9,11,7,4,9,5,9,7,3,3,7,7,5,6,2,6,2,3,6,4,5,3,1,2,3,2,5,1,1,0,1,2,4,2,5,3,4,3,6,4,2,5,2,2,1,4,1,3,1,2,6
0,0,0,0,1,2,82,173,74,53,31,31,19,24,16,13,12,8,6,13,15,8,8,6,8,6,1,6,4,5,3,8,7,4,9,4,4,1,2,3,3,4,6,7,1,5,4,2,5,4,1,2,3,1,4,3,6,1,0,1,3,6,3,4,1,1,0,2,0,1
0,0,0,0,0,1,17,55,56,30,35,20,26,15,20,13,12,14,18,11,8,9,5,8,6,8,4,4,7,3,1,5,5,8,0,3,3,6,2,7,4,5,2,4,2,5,1,5,5,3,1,3,8,2,1,2,3,5,3,4,3,3,2,1,3,1,3,1,0,3
0,0,0,0,0,1,7,19,22,18,29,19,18,13,21,14,13,10,5,7,12,6,9,8,9,7,9,7,6,4,3,5,3,6,2,2,6,3,1,4,3,7,4,2,2,4,2,3,3,2,2,3,0,2,1,4,3,2,2,2,2,0,3,1,4,1,2,1,1,4
0,0,0,0,0,0,2,6,8,11,10,12,8,17,8,15,8,7,17,11,6,10,8,7,10,5,13,5,4,5,2,9,3,7,4,3,2,6,4,4,3,1,6,3,5,2,6,2,0,1,4,3,3,2,1,4,8,6,5,2,1,4,2,1,3,2,3,5,6,2
0,0,0,0,0,1,1,0,2,5,4,6,10,4,13,8,7,8,11,3,2,5,3,2,5,4,5,4,4,9,3,5,3,4,5,5,7,3,4,2,2,3,3,3,2,4,2,3,2,0,2,2,1,3,2,3,0,5,4,4,2,1,3,2,3,4,2,4,1,0
0,0,0,0,0,0,0,0,2,4,3,4,4,9,10,6,8,5,8,6,5,6,2,9,3,7,4,3,6,7,4,6,6,2,3,2,1,5,5,1,5,4,3,6,2,2,3,2,2,2,0,1,0,2,1,3,2,2,5,3,1,3,0,2,1,4,8,2,0,1
0,0,0,0,0,0,0,0,2,1,0,2,3,3,4,4,2,2,3,6,3,5,4,1,2,3,2,8,1,4,2,4,1,5,2,3,2,1,5,2,0,6,2,1,5,2,6,5,2,0,3,1,1,4,0,3,0,2,0,6,1,2,2,1,3,3,0,0,2,2
0,0,0,0,0,0,1,0,0,0,1,0,2,4,1,1,3,1,4,4,5,3,4,2,3,0,2,0,4,1,4,2,4,1,6,3,1,4,2,3,5,3,1,1,1,6,0,2,0,3,2,3,1,1,1,3,2,1,1,0,2,1,0,2,1,2,2,2,2,0
0,0,0,0,0,0,0,0,0,0,1,1,2,0,4,5,2,2,2,2,3,2,1,2,2,4,2,1,3,3,4,3,3,5,5,4,2,1,0,3,4,1,4,1,1,2,0,3,2,0,1,1,1,1,0,2,3,3,3,2,2,1,1,3,1,5,0,1,1,1
0,0,0,0,0,0,0,0,0,0,0,0,1,1,1,2,1,1,0,3,1,2,0,2,1,0,2,2,1,1,2,3,1,1,4,1,4,1,2,0,4,0,3,2,1,1,1,2,1,4,0,1,2,0,1,2,1,0,3,0,0,2,1,3,1,0,2,1,1,2
0,0,0,0,0,0,0,0,0,0,0,0,0,1,1,2,1,1,2,1,0,0,1,0,2,3,2,1,0,0,1,1,2,4,0,0,0,1,3,2,1,1,0,3,1,2,0,2,1,4,0,1,3,1,1,2,1,1,1,2,1,4,0,0,0,1,0,1,1,2
0,0,0,0,0,0,0,0,0,0,0,0,0,0,1,0,0,0,2,0,2,0,0,1,0,2,0,0,2,0,2,0,0,1,0,2,0,3,0,1,1,3,1,1,1,1,2,2,0,1,1,2,4,1,0,2,0,0,0,1,1,0,1,0,0,0,1,2,1,0
0,0,0,0,0,0,0,0,0,0,0,0,0,0,0,0,2,0,0,0,0,1,2,1,1,0,0,0,0,3,0,2,1,1,1,0,1,2,0,0,2,2,0,0,1,2,0,1,3,2,0,1,1,2,0,1,0,3,3,2,2,3,0,2,1,2,0,2,0,0
0,0,0,0,0,0,0,0,0,0,0,0,0,0,0,1,0,0,0,1,0,0,0,0,0,0,0,1,0,0,1,1,0,0,0,1,0,3,1,1,2,0,0,1,0,0,1,0,0,0,0,0,0,0,0,0,0,3,0,1,2,1,2,2,1,1,1,0,0,1
0,0,0,0,0,0,0,0,0,0,0,0,0,0,1,0,1,0,0,0,0,0,0,0,0,0,0,0,0,0,0,0,0,2,1,1,1,0,2,0,0,0,2,0,2,0,1,2,3,0,1,0,2,1,1,0,0,2,1,1,0,2,1,0,2,0,0,1,0,1
0,0,0,0,0,0,0,0,0,0,0,0,0,0,0,0,0,0,0,0,0,0,0,2,0,0,0,0,0,1,2,0,0,0,0,0,1,2,0,1,0,0,0,2,1,1,0,0,1,1,0,2,0,1,0,0,0,0,0,0,0,1,0,1,0,1,0,1,1,0
0,0,0,0,0,0,0,0,0,0,0,0,0,0,0,0,0,1,0,0,0,0,1,0,0,1,0,0,1,1,1,0,0,0,2,0,0,0,0,0,0,0,0,1,1,1,0,1,0,1,0,1,2,0,0,0,1,0,2,0,1,0,0,1,1,0,2,1,0,0
0,0,0,0,0,0,0,0,0,0,0,0,0,0,0,0,0,0,0,0,0,0,0,0,0,1,0,0,0,0,0,0,0,0,0,1,1,0,1,0,1,0,1,0,1,1,0,0,0,0,0,0,2,0,0,3,0,1,2,2,2,0,1,1,0,0,0,0,2,0
0,0,0,0,0,0,0,0,0,0,0,0,0,0,0,0,0,0,0,0,0,0,0,0,0,0,0,0,0,0,0,0,0,0,0,0,0,0,0,0,1,0,0,1,0,0,0,1,0,0,0,0,0,0,0,0,0,0,2,0,0,0,0,0,0,3,0,1,1,1
0,0,0,0,0,0,0,0,0,0,0,0,0,0,0,0,0,0,0,0,0,0,0,0,0,0,0,0,0,0,0,0,0,0,0,0,0,0,1,1,0,0,1,0,1,0,0,0,0,0,0,0,1,1,1,0,0,0,0,0,0,1,0,0,0,0,1,2,0,0
0,0,0,0,0,0,0,0,0,0,0,0,0,0,0,0,0,0,0,0,0,1,0,0,0,0,0,0,0,0,0,0,0,0,0,0,0,1,0,0,0,0,0,0,0,0,0,0,0,0,0,0,0,0,1,0,0,1,0,0,0,0,0,0,0,0,0,0,2,0
0,0,0,0,0,0,0,0,0,0,0,0,0,0,0,0,0,0,0,0,0,0,0,0,0,0,0,0,0,0,0,0,0,0,0,0,0,0,0,0,0,0,1,0,0,1,0,0,0,0,0,0,0,0,0,0,0,0,0,1,0,0,0,1,0,0,1,0,0,0
0,0,0,0,0,0,0,0,0,0,0,0,0,0,0,0,0,0,0,0,0,0,0,0,0,0,0,0,0,0,0,0,0,0,0,0,0,0,0,0,0,0,0,1,1,0,0,0,0,1,0,0,0,0,0,0,0,0,0,0,0,0,1,0,0,0,0,0,0,0
0,0,0,0,0,0,0,0,0,0,0,0,0,0,0,0,0,0,0,0,0,0,0,0,0,0,0,0,0,0,0,0,0,0,1,0,0,0,0,0,0,0,0,0,0,0,0,0,0,0,0,0,1,0,0,0,0,0,0,0,0,0,0,0,0,0,0,0,0,0
0,0,0,0,0,0,0,0,0,0,0,0,0,0,0,0,0,0,0,0,0,0,0,0,0,0,0,0,0,0,0,0,0,0,0,0,0,0,0,0,0,0,0,0,0,0,0,0,0,0,0,0,0,0,1,1,0,0,0,1,0,1,1,0,0,1,1,0,1,0
0,0,0,0,0,0,0,0,0,0,0,0,0,0,0,0,0,0,0,0,0,0,0,0,0,0,0,0,0,0,0,0,0,0,0,0,0,0,0,0,0,0,0,0,0,0,0,0,0,0,0,0,0,0,0,0,0,0,0,0,0,0,0,0,1,0,1,0,0,0
0,0,0,0,0,0,0,0,0,0,0,0,0,0,0,0,0,0,0,0,0,0,0,0,0,0,0,0,0,0,0,0,0,0,0,0,0,0,0,0,0,0,0,0,0,0,0,0,0,0,0,0,0,0,0,0,0,0,0,0,1,0,0,1,0,1,0,0,0,0
0,0,0,0,0,0,0,0,0,0,0,0,0,0,0,0,0,0,0,0,0,0,0,0,0,0,0,0,0,0,0,0,0,0,0,0,0,0,0,0,0,0,0,0,0,0,0,0,0,0,1,0,0,0,0,1,0,1,0,0,0,0,0,0,0,0,0,0,1,0
0,0,0,0,0,0,0,0,0,0,0,0,0,0,0,0,0,0,0,0,0,0,0,0,0,0,0,0,0,0,0,0,0,0,0,0,0,0,0,0,1,0,0,0,0,0,0,0,0,0,0,0,0,0,0,0,0,0,0,0,0,0,0,0,0,0,0,0,0,1
0,0,0,0,0,0,0,0,0,0,0,0,0,0,0,0,0,0,0,0,0,0,0,0,0,0,0,0,0,0,0,0,0,0,0,0,0,0,0,0,0,0,0,0,0,0,0,1,0,0,0,0,0,0,0,0,0,0,0,0,0,0,0,0,0,0,0,0,0,0
0,0,0,0,0,0,0,0,0,0,0,0,0,0,0,0,0,0,0,0,0,0,0,0,0,0,0,0,0,0,0,0,0,0,0,0,0,0,0,0,0,0,0,0,0,0,0,0,0,0,0,0,0,0,0,0,0,0,0,0,0,0,1,0,0,0,0,0,0,0
0,0,0,0,0,0,0,0,0,0,0,0,0,0,0,0,0,0,0,0,0,0,0,0,0,0,0,0,0,0,0,0,0,0,0,0,0,0,0,0,0,0,0,0,0,0,0,0,0,0,0,0,0,0,0,0,0,0,0,0,0,0,0,0,0,0,0,0,0,0
0,0,0,0,0,0,0,0,0,0,0,0,0,0,0,0,0,0,0,0,0,0,0,0,0,0,0,0,0,0,0,0,0,0,0,0,0,0,0,0,0,0,0,0,0,0,0,0,0,0,0,0,0,0,0,0,0,0,0,0,0,0,0,0,0,0,0,0,0,0
0,0,0,0,0,0,0,0,0,0,0,0,0,0,0,0,0,0,0,0,0,0,0,0,0,0,0,0,0,0,0,0,0,0,0,0,0,0,0,0,0,0,0,0,0,0,0,0,0,0,0,0,0,0,0,0,0,0,0,0,0,0,0,0,0,0,0,0,0,0
0,0,0,0,0,0,0,0,0,0,0,0,0,0,0,0,0,0,0,0,0,0,0,0,0,0,0,0,0,0,0,0,0,0,0,0,0,0,0,0,0,0,0,0,0,0,0,0,0,0,0,0,0,0,0,0,0,0,0,0,0,0,0,0,0,0,0,0,0,0
